%%%%%%%%%%%%%%%%%%%%
%   %%   9    %   9%
%                  %
%9%     %9%%%%   %9%
%9%9%%9%%  %%9%%9%9%
%9      G   P9%    %
%9                 %
% %    %    % %  % %
% % 9 9% %%%% %  % %
% %      9    %  % %
% %% % %%%%%% % %% %
%   9%    P   %    %
%%%%%%%%%%%%%%%%%%%%