%%%%%%%%%%%%%%%%%%%%
%    %   P    %   9%
%                  %
%9%     %9%      %9%
%9%9%%9%%  %%9%%9%9%
%P      G   %9%    %
%9                 %
% %    %    % %  % %
% % P 9% %%%% %  % %
% %      9    %  % %
% %% % %%%%%% % %% %
%   9%    P   %    %
%%%%%%%%%%%%%%%%%%%%