%%%%%%%%%%%%%%%%%%%%
%   9% 9 9 9 9% 9G9%
%9%%9%9%%%%%%9%9%%9%
%9% 9 9 9 9 9 9 9%9%
%9%9%%9%%  %%9%%9%9%
% 9 9 9%G  G% 9 9 9%
%9%9%%9%%%%%%9%%9%9%
%9% 9G 9 9 9 9 99%9%
%9%%9%9%%%%%%9%9%%9%
% 9 9% 99P 9 9% 99%%
%%%%%%%%%%%%%%%%%%%%
