%%%%%%%%%%%%%%%%%%%%
%  99%99999999%99G9%
%9%%9%9%%%%%%9%9%%9%
%9%99999999999999%9%
%9%9%%9%%  %%9%%9%9%
%999999%G  G%999999%
%9%9%%9%%%%%%9%%9%9%
%9%99G99999999999%9%
%9%%9%9%%%%%%9%9%%9%
%9999%999P9999%999%%
%%%%%%%%%%%%%%%%%%%%
