%%%%%%%%%%%%%%%%%%%%
% 999%99999999%999 %
%9%%9%9%%99%%9%9%%9%
%9%99999%99%99999%9%
%9%9%%9%%  %%9%%9%9%
%999999 GGGG%9%9999%
%9%9999%%%%%%9%99%9%
%9%9999%    %9%99%9%
%9%9999% %%%%9%99%9%
%9%99999999999%99%9%
%9%%9%9%%%%%%9%9%%9%
% 999%999P9999%999 %
%%%%%%%%%%%%%%%%%%%%
